1111111111111111
1010010000100001
1000C010C0010101
1C0000E000010101
10001000P0010101
1000001000010100
1111111111111111
