111111111111111111
1PCCCCCCCCCCCCCCE1
111111111111111111