11111111111111111111111111111111111
1ECCCCCCCCCCCCCCCCCCCCCCCCCCCCCCC11
1CCCCCCCCCCCCCCCCCCCCCCCCCCCCCCCC11
1C111111111111111111111111111111111
1CCCCCCCCCCCCCCCCCCCCCCCCCCCCCCCCC1
11111111111111011111111111111111111
1CCCCCCCCCCCCCCCCCCCCCCCCCCCCCCCC11
1CCCCCCCCCCCCCCCCCCCCCCCCCCCCCCCC11
1C111111111111111111111111111111111
1CCCCCCCCCCCCCCCCCCCCCCCCCCCCCCCCC1
11111111111111110111111111111111111
1CCCCCCCCCCCCCCCCCCCCCCCCCCCCCCCC11
1CCCCCCCCCCCCCCCCCCCCCCCCCCCCCCCC11
1C111111111111111111111111111111111
1CCCCCCCCCCCCCCCCCCCCCCCCCCCCCCCCC1
11111111111111111111110111111111111
1CCCCCCCCCCCCCCCCCCCCCCCCCCCCCCCC11
1CCCCCCCCCCCCCCCCCCCCCCCCCCCCCCCC11
1C111111111111111111111110111111111
100000000000000000000000000000000P1
11111111111111111111111111111111111